. K K L M M
U E . L F J
U E A A F J
B B C . D J
. . C . D .
. . . G G G
