U P . . J C
U P D D J C
U . A A G C
. Y E . G .
. Y E H F F
. Y E H . .
